20 60
02 02 02 02 02 02 02 02 02 02 02 02 02 02 02 02 02 02 02 02 02 02 02 02 02 02 02 02 02 02 02 02 02 02 02 02 02 02 02 02 02 02 02 02 02 02 02 02 02 02 02 02 02 02 02 02 02 02 02 02
01 04 00 00 00 00 00 01 00 00 00 00 00 00 00 00 00 00 00 00 00 00 00 00 00 00 00 00 00 00 00 00 00 00 00 00 00 00 00 00 00 00 00 00 00 00 00 00 00 00 00 00 00 00 00 00 00 00 00 01
01 00 00 00 00 01 00 01 00 00 00 00 00 00 00 00 00 00 00 00 00 00 00 00 00 00 00 00 00 00 00 01 00 00 00 00 00 00 02 02 02 02 02 02 02 02 02 00 00 00 00 00 00 00 00 00 00 00 00 01
01 02 02 02 00 01 00 01 00 00 00 00 00 00 00 00 02 02 02 02 02 02 00 00 00 00 00 00 00 00 01 00 01 00 00 00 00 01 00 00 00 01 00 00 00 01 00 00 00 00 00 00 00 00 00 00 00 00 00 01
01 00 00 00 00 00 99 01 00 00 00 00 00 00 00 02 02 02 02 02 02 02 02 00 00 00 00 00 00 01 00 00 00 01 00 00 00 01 00 00 00 01 00 00 00 01 00 01 00 00 00 00 00 00 00 00 00 00 00 01
01 00 99 02 02 02 00 01 00 00 00 00 00 00 02 02 02 02 02 02 02 02 02 02 00 00 00 00 01 00 00 00 00 00 01 00 00 01 00 00 00 00 00 00 00 00 00 01 00 00 00 00 00 00 00 00 00 00 00 01
01 00 00 00 01 00 00 01 00 00 00 00 00 02 02 02 02 02 02 02 02 02 02 02 02 00 00 00 00 00 00 00 00 00 00 00 00 01 00 01 01 99 01 01 01 01 01 01 00 00 00 00 00 00 00 00 00 00 00 01
01 00 01 00 01 00 00 00 00 00 00 00 02 02 02 02 02 02 02 02 02 02 02 02 02 02 00 00 00 00 29 00 29 00 00 00 00 01 00 00 00 99 00 00 00 00 00 01 00 00 01 00 00 01 00 01 01 00 00 01
01 00 00 00 00 00 00 00 00 00 00 00 00 00 00 00 00 00 00 00 00 00 00 00 00 00 00 00 00 00 29 33 29 00 00 00 00 01 00 00 01 01 01 00 01 00 00 01 00 00 01 00 01 01 00 01 01 01 00 01
01 02 02 02 02 02 02 02 00 00 00 00 00 00 00 00 01 00 00 00 00 01 00 00 00 00 00 00 00 00 00 00 00 00 00 00 00 01 01 00 00 00 00 00 01 00 00 01 00 00 01 01 01 00 00 01 00 01 00 01
01 00 00 00 00 00 00 00 00 00 00 00 00 00 00 01 01 01 00 00 01 01 01 00 00 00 00 00 01 00 00 00 00 00 01 00 00 01 00 01 00 01 00 00 01 00 00 01 00 00 01 01 00 00 00 01 00 01 00 01
01 00 00 00 00 00 00 00 00 00 00 00 00 00 00 01 01 01 00 00 01 01 01 00 00 00 00 00 00 01 00 00 00 01 00 00 00 01 00 00 00 01 00 99 00 01 01 01 00 00 01 00 01 00 00 01 00 01 00 01
01 00 00 00 00 01 00 00 00 29 32 29 00 00 00 00 01 00 00 00 00 01 00 00 00 00 01 00 00 00 01 00 01 00 00 00 01 01 00 99 99 01 00 01 00 00 00 01 00 00 01 00 00 01 00 01 01 01 00 01
01 00 00 00 01 01 01 00 00 29 00 29 00 00 00 00 00 00 00 00 00 00 00 00 00 00 00 01 00 00 00 01 00 00 00 01 00 01 00 00 00 01 00 00 09 09 09 01 00 00 01 00 00 01 00 01 01 00 00 01
01 00 00 01 01 01 01 01 00 00 00 00 00 00 01 01 00 00 00 00 00 00 01 01 00 00 00 00 01 00 00 00 00 00 01 00 00 01 00 01 00 00 00 00 00 00 11 01 00 00 00 00 00 00 00 00 00 00 00 01
01 00 00 00 01 01 01 00 00 00 00 00 00 00 00 00 01 00 00 00 00 01 00 00 00 00 00 00 00 01 00 00 00 01 00 00 00 01 00 01 00 00 00 00 09 09 09 01 00 00 00 00 00 00 00 00 00 00 00 01
01 00 00 00 00 01 00 00 00 00 00 00 00 00 00 00 00 01 00 00 01 00 00 00 00 00 00 00 00 00 01 00 01 00 00 00 00 00 02 02 02 02 02 02 02 02 02 00 00 00 00 00 00 00 00 00 00 00 00 01
01 00 00 00 00 00 00 00 00 00 00 00 00 00 00 00 00 00 01 01 00 00 00 00 00 00 00 00 00 00 00 01 00 00 00 00 00 00 00 00 00 00 00 00 00 00 00 00 00 00 00 00 00 00 00 00 00 00 00 01
01 00 00 00 00 00 00 00 00 00 00 00 00 00 00 00 00 00 00 00 00 00 00 00 00 00 00 00 00 00 00 00 00 00 00 00 00 00 00 00 00 00 00 00 00 00 00 00 00 00 00 00 00 00 00 00 00 00 00 01
02 02 02 02 02 02 02 02 02 02 02 02 02 02 02 02 02 02 02 02 02 02 02 02 02 02 02 02 02 02 02 02 02 02 02 02 02 02 02 02 02 02 02 02 02 02 02 02 02 02 02 02 02 02 02 02 02 02 02 02